AK Alaska - Juneau
AL Alabama - Montgomery
AR Arkansas - Little Rock
AS American Samoa
AZ Arizona - Phoenix
CA California - Sacramento
CO Colorado - Denver
CT Connecticut - Hartford
DC District of Columbia, which is the seat of the Federal government
DE Delaware - Dover
FL Florida - Tallahassee
GA Georgia - Atlanta
GU Guam
HI Hawaii - Honolulu
IA Iowa - Des Moines
ID Idaho - Boise
IL Illinois - Springfield
IN Indiana - Indianapolis
KS Kansas - Topeka
KY Kentucky - Frankfort
LA Louisiana - Baton Rouge
MA Massachusetts - Boston
MD Maryland - Annapolis
ME Maine - Augusta
MI Michigan - Lansing
MN Minnesota - Saint Paul
MO Missouri - Jefferson City
MP Northern Mariana Islands, Commonwealth
MS Mississippi - Jackson
MT Montana - Helena
NC North Carolina - Raleigh
ND North Dakota - Bismarck
NE Nebraska - Lincoln
NH New Hampshire - Concord
NJ New Jersey - Trenton
NM New Mexico - Santa Fe
NV Nevada - Carson City
NY New York - Albany
OH Ohio - Columbus
OK Oklahoma - Oklahoma City
OR Oregon - Salem
PA Pennsylvania - Harrisburg
PR Puerto Rico, Commonwealth
RI Rhode Island - Providence
SC South Carolina - Columbia
SD South Dakota - Pierre
TN Tennessee - Nashville
TX Texas - Austin
UT Utah - Salt Lake City
VA Virginia - Richmond
VI the United States Virgin Islands
VT Vermont - Montpelier
WA Washington - Olympia
WI Wisconsin - Madison
WV West Virginia - Charleston
WY Wyoming - Cheyenne
